1111111111111111111111111111111111111111111111111111111111111111111111111111111
1000000000000000000000000000000000000001100000000000000000000000000000000000001
1000000000000000000000000000000000000001100000000000000000000000000000000000001
1000000000000000000000000000000000000001100000000000000000000000000000000000001
1000000000000000000000000000000000000001100000000000000000000000000000000000001
1000000000000000000000000000000000000001100000000000000000000000000000000000001
1000000000000000000000000000000000000001100000000000000000000000000000000000001
1000000000000000000000000000000000000001100000000000000000000000000000000000001
1000000000000000000000000000000000000001100000000000000000000000000000000000001
1000000000000000000000000000000000000001100000000000000000000000000000000000001
1000000000000000000000000000000000000001100000000000000000000000000000000000001
1000000000000000000000000000000000000A0110B000000000000000000000000000000000001
1000000000000000000000000000000000000001100000000000000000000000000000000000001
1000000000000000000000000000000000000001100000000000000000000000000000000000001
1000000000000000000000000000000000000001100000000000000000000000000000000000001
1000000000000000000000000000000000000001100000000000000000000000000000000000001
1000000000000000000000000000000000000001100000000000000000000000000000000000001
1000000000000000000000000000000000000001100000000000000000000000000000000000001
1000000000000000000000000000000000000001100000000000000000000000000000000000001
1000000000000000000000000000000000000001100000000000000000000000000000000000001
1000000000000000000000000000000000000001100000000000000000000000000000000000001
1000000000000000000000000000000000000001100000000000000000000000000000000000001
1000000000000000000000000000000000000001100000000000000000000000000000000000001
1111111111111111111111111111111111111111111111111111111111111111111111111111111