1111111111111111111111111111111111111111111111111111111111111111111111111111111
1000000000000000000000000000000000000001B00000000000000000000000000000000000001
1000000000000000000000000000000000000001000000000000000000000000000000000000001
1000000000000000000000000000000000000001000000000000000000000000000000000000001
1000000000000000000000000000000000000001000000000000000000000000000000000000001
1000000000000000000000000000000000000001000000000000000000000000000000000000001
1000000000000000000000000000000000000001000000000000000000000000000000000000001
10000000000000000000000000000000000000A1000000000000000000000000000000000000001
1111111111111111111111111111111111111111111111111111111111111111111111111111111
1000000000000000000000000000000000000000000000000000000000000000000000000000001
1000000000000000000000000000000000000000000000000000000000000000000000000000001
10000000000000000000000000000000000000000000000000000000000000000000000000000X1
1000000000000000000000000000000000000000000000000000000000000000000000000000001
1000000000000000000000000000000000000000000000000000000000000000000000000000001
1000000000000000000000000000000000000000000000000000000000000000000000000000001
1111111111111111111111111111111111111111111111111111111111111111111111111111111
10000000000000000000000000000000000000D1000000000000000000000000000000000000001
1000000000000000000000000000000000000001000000000000000000000000000000000000001
1000000000000000000000000000000000000001000000000000000000000000000000000000001
1000000000000000000000000000000000000001000000000000000000000000000000000000001
1000000000000000000000000000000000000001000000000000000000000000000000000000001
1000000000000000000000000000000000000001000000000000000000000000000000000000001
1000000000000000000000000000000000000001E00000000000000000000000000000000000001
1111111111111111111111111111111111111111111111111111111111111111111111111111111